8
7
1 3 3 3 3 3 3 1
2 8 0 0 2 0 0 2
2 0 0 0 2 0 0 2
2 0 0 0 1 3 8 2
2 0 8 0 0 0 0 2
2 4 0 8 0 0 8 2
1 3 3 3 3 3 3 1

1 3 3 3 3 3 3 1
2 0 0 0 0 0 8 2
2 0 8 0 8 0 0 2
2 0 0 8 0 4 0 2
2 0 0 8 0 8 0 2
2 5 0 0 8 0 8 2
1 3 3 3 3 3 3 1

1 3 3 3 3 3 3 1
2 0 0 0 0 8 0 2
2 3 1 8 0 0 0 2
2 8 2 0 8 5 0 2
2 8 0 0 8 8 8 2
2 6 2 0 0 0 0 2
1 3 3 3 3 3 3 1
